000000000000000000000000000000000000000000000000000000000000000000
000000000000000000000000000000000000000000000000000000000000000000
000000000000000000000000000000000000000000000000000000000000000000
000000000000000000000000000000000000000000000000000000000000000000
000000000000000000000000000000000000000000000000000000000000000000
000000000000000000000000000000000000000000000000000000000000000000
000000000000000000000000000000000000000000000000000000000000000000
000000000000000000000000000000000000000000000000000000000000000000
000000000000000000000000000000000000000000000000000000000000000000
000000000000000000000000000000000000000000000000000000000000000000
000000000000000000000000000000007788888888888888888800000000000000
000000000000000000000000000000008888888888330000008800000000000000
000000000000000000000000000000000000880088008888888800000000000000
000000000000000000000000000000000000880088118811003388000000000000
000000000000000000000000000000000000880088882288880088000000000000
000000000000000000000000000000000000883300118811880088000000000000
000000000000000000000000000000000000008888888800880088000000000000
000000000000000000000000000000000000008800000033888888000000000000
000000000000000000000000000000000000008888888888000000000000000000
000000000000000000000000000000000000000000000000000000000000000000
000000000000000000000000000000000000000000000000000000000000000000
000000000000000000000000000000000000000000000000000000000000000000
