000000000000000000000000000000000000000000000000000000000000000000
000000000000000000000000000000000000000000000000000000000000000000
000000000000000000000000000000000000000000000000000000000000000000
000000000000000000000000000000008888000000000000000000000000000000
000000000000000000000000000000008811888811888800000000000000000000
000000000000000000000000000000008888000088888800000000000000000000
000000000000000000000000000000008888333300880000000000000000000000
000000000000000000000000000000008811333300110000000000000000000000
000000000000000000000000000000000088333300888888000000000000000000
000000000000000000000000000000008888000088888888000000000000000000
000000000000000000000000000000007711888811888888000000000000000000
000000000000000000000000000000008888000000000000000000000000000000
000000000000000000000000000000000000000000000000000000000000000000
000000000000000000000000000000000000000000000000000000000000000000
000000000000000000000000000000000000000000000000000000000000000000
000000000000000000000000000000000000000000000000000000000000000000
000000000000000000000000000000000000000000000000000000000000000000
000000000000000000000000000000000000000000000000000000000000000000
000000000000000000000000000000000000000000000000000000000000000000
000000000000000000000000000000000000000000000000000000000000000000
000000000000000000000000000000000000000000000000000000000000000000
000000000000000000000000000000000000000000000000000000000000000000
